11
8 5
# # # # # 
# _ _ _ # 
# _ G _ # 
# _ _ _ #
# # _ # # 
# G _ _ # 
# _ _ _ # 
# # # # #
Player 6 2
Enemy 3 2 WF R
