11
9 5
# # # # # 
# _ _ G #
# _ _ _ #
# _ _ _ #
# _ _ _ #
# _ _ _ #
# # _ # #
# G _ # #
# # # # #
Player 7 2
Enemy 5 3 SL U
