14
12 5
# # # # #
# _ G _ # 
# _ _ _ # 
# _ _ _ # 
# # D # # 
# _ _ _ # 
# _ _ _ #
# _ _ _ # 
# # D # # 
# _ _ _ # 
# _ _ _ #
# # # # #
Player 10 2
Token 9 3
TDoor 8 2 1
Token 5 1
TDoor 4 2 2
