10
8 5
# # # # # 
# _ G _ # 
# _ _ _ # 
# _ _ _ #
# # D # # 
# _ _ _ # 
# _ _ _ # 
# # # # #
Player 6 2
Enemy 3 1 SL R
TDoor 4 2 10
