15
9 9
# # # # # # # # #
# _ _ _ # _ _ _ #
# G _ T # T _ _ #
# _ _ _ # _ T _ #
# # # # # # # # #
# _ _ _ # _ T _ #
# _ _ T # T _ _ #
# _ _ _ # _ _ _ #
# # # # # # # # # 
Player 7 2
Tele 6 3 6 5
Tele 6 5 6 3
Tele 5 6 3 6
Tele 3 6 5 6
Tele 2 5 2 3
Tele 2 3 2 5
